1111111111111
1100006000001
1008000000001
1110006800001
1008010801001
1020000600001
1001000010001
1001080101001
1600000060001
1111111111111