1111111111111
1080000600101
1011108001101
1000800020001
1060108010801
1008000600001
1080006011601
1001080060111
1110060000001
1111111111111