1111111111111
1116010001011
1080060910601
1018000000001
1000801060801
1008060800001
1080001060001
1018102016001
1000006000101
1111111111111