1111111111111
1100006000001
1008000000101
1110006800101
1008000000001
1060820006001
1000000000011
1000000000011
1000000000001
1111111111111