1111111111111
1108006000111
1000000100001
1110806800061
1008000101001
1020010600801
1001008010001
1010000101001
1600100106001
1111111111111